11111111111111
1P1010C00C01C1
10111001000001
10000000010011
101011C10000E1
11111111111111
